1111111
1000001
1CE1111
1111111