11111111
10000C11
1P000111
11111111