1111111
100001
1PCE001
1111111