1111111
1P000E1
10C11P1
1111111