111111111

100000001
1E0001P11
1000CC001
111111111