11111111111111111111
100000000000C0000001
1FFFF1000C00000000E1
100000000000000C00P1
11111111111111111111