111111
100011
100C11
1PEF11
111111