1111111111111
1P10010001001
1010010E00011
1C00C10000001
11100C0100001
1C00100100001
1111111111111