111111111111111
1P11111111111E1
111000110110111
110110110110111
110110110110111
111000110000111
110110110110111
101110110110111
111111111111111
1C11111111111C1
111111111111111